700 550 0
100

5
5
0 0 1000 0 1000 600 0 600 0 0
7
0 400 150 380 300 430 350 450 350 600 0 600 0 400
10
500 500 750 500 875 350 800 300 700 250 450 100 100 80
200 200 350 300 500 500
4
850 600 1000 400 1000 600 850 600
6
550 0 600 80 900 180 1000 200 1000 0 550 0

34
750  500  750  600  790  450  850  600  832  400  900  532
875  350  1000 400  800  300  1000 300  800  300  855  165
700  250  752  131  550  160  600  80   450  100  450  0
350  0    350  95   200  0    200  86   0    80   100  80
0    200  200  200  150  380  200  200  300  430  350 300
350  450  500  500  500  500  500  600